 #####
#     # #####   ##    ####  ######
#         #    #  #  #    # #
 #####    #   #    # #      #####
      #   #   ###### #  ### #
#     #   #   #    # #    # #
 #####    #   #    #  ####  ######
